#################################################
#Q...s...#.#..........................#.........#
#........###....##..........##........#.........#
#........#......##..........##........#.........#
#........#............................#.........#
#........#............................#.........#
#........#......##..........##........#.........#
#........#......##..........##........#.........#
#........#..................##........#.........#
#...............................................#
#........#..................##........#.........#
#........#......##..........##........#.........#
#........#......##..........##........#.........#
#........#............................#.........#
#........#............................#.........#
#s...@...#......##..........##........#.........#
#........###....##..........##........#.........#
#........#.#..........................#.........#
#################################################