#########
#@......#
#.......#
#....q.s#
#########